###############
#...#.........#
#.#.#.#.#.###.#
#S#...#.#.#...#
#######.#.#.###
#######.#.#...#
#######.#.###.#
###..E#...#...#
###.#######.###
#...###...#...#
#.#####.#.###.#
#.#...#.#.#...#
#.#.#.#.#.#.###
#...#...#...###
###############